Columns: 50
Rows: 28
0::::::::::::::::::::::::::::::::::::::::::::::::0
0::::::::::::::::::::::::::::::::::::::::::::::::0
0QKKKKKKNKKKKKKKKKKKKOKKKKOKKKKKKRQKKKKKKKKPKKKKK0
0QPKKKKKKOKKKKKKKNKKKKKKKKNKKKKKKRQKKKKKKKKKKKKKK0
0QKKKKKKKKKPKKKKKKKKKKKKKKKKKKKKKRQKKKKKKKKKKKKKK0
0XXXXXXX0XXXXXXXX00XXXXXXX0XXXXXXXXXXXXXXXXXXXXXX0
0UUUUUUU0UUUUUUUU00UUUUUUUUUUUUUUPPUUUUUUUUUUUUUU0
0YYYYYYY0YYYYYYYY00YYYYYYY0YYYYYYYYYYYYYYYYYYYYYY0
0YYYYYYY0YYYYYYYY00YYYYYYY0YYYYYYYYYYYYYYYYYYYYYY0
0YYYYYYY0YYYYYYYY00YYYYYYY0YYYYYYYYY14YYYYYYYYYYY0
0YYYYYYY0YYYYYYYY00YYYYYYY0YYYYYYYYY41YYYYYYYYYYY0
0YYYYYYY0000000000000000000YYYYYYYYY41YYYYYYYYYYY0
0YYYYYYY0YYYYY0YYYYYYYYYYYPYYYYYYYYYY111411YYYYYY0
0YYYYYYY0YYYYY0YYYYYYYYYYYPYYYYYYYYYYYYYYYYYYYYYY0
0YYYYYYY0YYYYY0YYYYYYYYYYYPYYYYYYYYYYY14141YYYYYY0
0YYYYYYY0000000000000000000YYYYYYYYYYYYYYYYYYYYYY0
0YYYYYYYYYYYYYYYYYYYYYYYYYYYYYYYYYYYYYYYYYYYYYYYY0
0YYYYYYYYYYYYYYYYYYYYYYYYYYYYYYYYYYYYYYYYYYYYYYYY0
0YYYYYYY00000000000000YYYYYYYYYYYYYYYYYYYYYYYYYYY0
0YYYYYYYYYYYYYYYYYYYY0YYYYYYYYYYYYYYYYPPYYYYYYYYY0
0YYYYYYYYYYYYYYYYYYYY000XXXXXXXXXXXXXXXXXXXXXXXX00
0YYYYYYYYY0YYYYYYYYYY0VLLLLLLLLLLLLLLLLLLLLLLLLLW0
0YYYYYYYYYY0YYYYYYYYYYVLLLLLLLT2LLLLLLLLLLLLLLLLW0
0YYYYYYYYYYYYYYYYYYYYYVLLLLLTLLLLTLLTVXXXWTLLTLLW0
0YYYYYYYYYYYYYYYYYYYYYVLLLLLLLTTLLLLLVKKKWLLLLLLW0
0YYYYY00000000YYYYYYYYVLLLLLLLLLLLLLLTVUUWLLLLLLW0
0YYYYYYYYYYYYYYYYYYYYYVLLLLLLLLLLLLLLLLLLLLLTLLLW0
00000000000000000000000000000000000000000000000000