Columns: 40
Rows: 25
00000000000000000000000000000000000000CD
0::::::::::::::::::::::::::::::::::KKKEF
0QKKKKKKNKKKKKKKKKKKKOKKKKOKKKKKKR:KKKCD
0QPKKKKKKOKKKKKKKNKKKKKKKKNKKKKKKR:KKKEF
0QKKKKKKKKKPKKKKKKKKKKKKKKKKKKKKKR:KKK;<
0KKKKKKK0YYYYYYYY00YYYYYYYYKKKKKKKKKKK=>
0KKKKKKK0YYYYYYYY00YYYYYYY0KKKKKKKKKKK;<
0KKKKKKK0YYYYYYYY00YYYYYYY0KKKKKKKKKKK=>
0KKKKKKK0YYYYYYYY00YYYYYYY0KKKKKKKKKKK;<
0KKKKKKK0YYYYYYYY00YYYYYYY0KKKKKKKKKKK=>
0KKKKKKK0YYYYYYYY00YYYYYYY0KKKKKKKKKKK;<
0KKKKKKK0000000000000000000KKKKKKKKKKK=>
0KKKKKKK0YYYYYYYYYYYYYYYYY0KKKKKKKKKKK;<
0KKKKKKK0YYYYYYYYYYYYYYYYY0KKKKKKKKKKK=>
0KKKKKKK0YYYYYYYYYYYYYYYYY0KKKKKKKKKKK;<
0KKKKKKK00000000000000YYYYYKKKKKKKKKKK=>
0KKKKKKKYYYYYYYYYYYYYYYYYYYKKKKKKKKKKK;<
0KKKKKKKYYYYYYYYYYYYYYYYYYYKKKKKKKKKKK=>
0KKKKKKK00000000000000YYYYYKKKKKKKKKKK;<
0KKKKKKKYYYYYYYYYYYYY0YYYYYKKKKKKKKKKK=>
0KKKKKKKYYYYYYYYYYYYY0YYYYYKKKKKKKKKKK;<
0KKKKKKKYY0YYYYYYYYYY0YYYYYKKKKKKKKKKK=>
0KKKKKKKYYY0YYYYYYYYYYYYYYYKKKKKKKKKKK;<
0KKKKKKKYYYYYYYYYYYYYYYYYYYKKKKKKKKKKK=>
0000000000000000000000000000000000000000

;
<
=
>