Columns: 35
Rows: 25
00000000000000000000000000000000000
0:::::::::::::::::::::::::::::::::0
0QKKKKKKNKKKKKKKKKKKKOKKKKOKKKKKKR0
0QPKKKKKKOKKKKKKKNKKKKKKKKNKKKKKKR0
0QKKKKKKKKKPKKKKKKKKKKKKKKKKKKKKKR0
0YYYYYYY0YYYYYYYY00YYYYYYYYYYYYYYY0
0YYYYYYY0YYYYYYYY00YYYYYYY0YYYYYYY0
0YYYYYYY0YYYYYYYY00YYYYYYY0YYYYYYY0
0YYYYYYY0YYYYYYYY00YYYYYYY0YYYYYYY0
0YYYYYYY0YYYYYYYY00YYYYYYY0YYYYYYY0
0YYYYYYY0YYYYYYYY00YYYYYYY0YYYYYYY0
0YYYYYYY0000000000000000000YYYYYYY0
0YYYYYYY0YYYYYYYYYYYYYYYYY0YYYYYYY0
0YYYYYYY0YYYYYYYYYYYYYYYYY0YYYYYYY0
0YYYYYYY0YYYYYYYYYYYYYYYYY0YYYYYYY0
0YYYYYYY00000000000000YYYYYYYYYYYY0
0YYYYYYYYYYYYYYYYYYYYYYYYYYYYYYYYY0
0YYYYYYYYYYYYYYYYYYYYYYYYYYYYYYYYY0
0YYYYYYY00000000000000YYYYYYYYYYYY0
0YYYYYYYYYYYYYYYYYYYY0YYYYYYYYYYYY0
0YYYYYYYYYYYYYYYYYYYY0YYYYYYYYYYYY0
0YYYYYYYYY0YYYYYYYYYY0YYYYYYYYYYYY0
0YYYYYYYYYY0YYYYYYYYYYYYYYYYYYYYYY0
0YYYYYYYYYYYYYYYYYYYYYYYYYYYYYYYYY0
00000000000000000000000000000000000